et	and
que	and
sī	if
nec	and not, nor; nec ... nec, neither ... nor; → neque
sed	but
aut	or
atque	and
ac	and
nē	lest, that not
enim	for, indeed
tamen	nevertheless, still
nam	for, indeed
namque	for, indeed
neque	and not, nor
at	but, but yet
quoque	also, too
an	or
nisi	if not, unless
nī	if not, unless
dum	while; until; provided that
autem	moreover, but, however
quia	because
ergō	therefore
vel	or else, or; even; vel ... vel: either … or
itaque	and so, therefore
uterque utraque utrumque	each of two
ve	or (postpositive enclitic)
igitur	therefore	Conjunction
seu	whether; seu ... seu: whether ... or → sīve
sīve	whether; sīve ... sīve: whether ... or → seu
postquam	after
quoniam	since, seeing that
quamquam	however, although
dōnec	until
licet	even though
antequam	before
utrum	whether; utrum ... an: whether ... or
quōmodo	in what way, how?