terra	-ae	f	land
vita	-ae	f	life
causa	-ae	f	cause
fortuna	-ae	f	fortune
natura	-ae	f	nature
cura	-ae	f	care
ira	irae	f	anger
via	-ae	f	street
unda	-ae	f	wave
poena	-ae	f	punishment
puella	-ae	f	girl
silva	-ae	f	forest
umbra	-ae	f	shadow
aqua	-ae	f	water
fama	-ae	f	rumor
flamma	-ae	f	flame
turba	-ae	f	crowd
copia	-ae	f	abundance (pl)troops
patria	-ae	f	fatherland
lacrima	-ae	f	tear
gloria	-ae	f	glory
fuga	-ae	f	flight
ara	-ae	f	altar
gratia	-ae	f	gratitude
iniuria	-ae	f	injustice
mora	-ae	f	delay
coma	-ae	f	hair
aura	-ae	f	breeze
forma	-ae	f	shape
anima	-ae	f	spirit
femina	-ae	f	woman
pecunia	-ae	f	money
sententia	-ae	f	judgement
provincia	-ae	f	province
praeda	-ae	f	prey
memoria	-ae	f	memory
pugna	-ae	f	battle
ripa	-ae	f	riverbank
hora	-ae	f	hour
amicitia	-ae	f	friendship
invidia	-ae	f	envy
littera	-ae	f	letter (pl)literature
divitiae	-arum	f	wealth
lingua	-ae	f	language
mensa	-ae	f	table
victoria	-ae	f	victory
porta	-ae	f	gate
culpa	-ae	f	fault
tenebrae	-brarum	f	darkness
sapientia	-ae	f	wisdom
opera	-ae	f	work
materia	-ae	f	material
luna	-ae	f	moon
insula	-ae	f	island
filia	-ae	f	daughter
filius	-i	m	son
poeta	-ae	m	poet
stella	-ae	f	star
familia	-ae	f	family
epistula	-ae	f	letter
fabula	-ae	f	story
scientia	-ae	f	knowledge
disciplina	-ae	f	discipline
amicus	-i	m	friend
animus	-i	m	mind
deus	-i	m	god
dea	-ae	f	goddess
locus	-i	m	place
vir	viri	m	man
bellum	-i	n	war
arma	-orum	n	weapons
caelum	-i	n	heavens
regnum	-i	n	kingdom
populus	-i	m	people
fatum	-i	n	fate
annus	-i	m	year
beneficium	-i	n	kindness
verbum	-i	n	word
puer	pueri	m	boy
modus	-i	m	measure
imperium	-i	n	command
oculus	-i	m	eye
natus	-i	m	son
consilium	-i	n	plan council
castrum	-i	n	fortress (pl)camp
ferrum	-i	n	iron
dominus	-i	m	lord
domina	-ae	f	mistress
equus	-i	m	horse
telum	-i	n	spear
signum	-i	n	sign
periculum	-i	n	danger
ventus	-i	m	wind
aurum	-i	n	gold
saxum	-i	n	rock
ager	agri	m	field
vitium	-i	n	vice
votum	-i	n	vow
iugum	-i	n	yoke ridge
numerus	-i	m	number
proelium	-i	n	battle
mundus	-i	m	world
tectum	-i	n	roof
ingenium	-i	n	ability
campus	-i	m	field
spatium	-i	n	space
somnus	-i	m	sleep
studium	-i	n	eagerness
legatus	-i	m	lieutenant
tergum	-i	n	rear
donum	-i	n	gift
membrum	-i	n	limb
templum	-i	n	temple
servus	-i	m	slave
murus	-i	m	wall
exemplum	-i	n	example
odium	-i	n	hatred
auxilium	-i	n	support
praesidium	-i	n	garrison
vinculum	-i	n	bond
officium	-i	n	duty
factum	-i	n	deed
pretium	-i	n	price
pontus	-i	m	sea
oppidum	-i	n	town
arvum	-i	n	field
vinum	-i	n	wine
maritus	-i	m	husband
morbus	-i	m	disease
vulgus	-i	c	commoner
praemium	-i	n	bounty
supplicium	-i	n	penalty
astrum	-i	n	star
dolus	-i	m	device
superi	-orum	m	gods
otium	-i	n	leisure
vestigium	-i	n	footstep
gaudium	-i	n	delight
humus	-i	f	ground
iudicium	-i	n	judgment
barbarus	-i	m	foreigner
saeculum	-i	n	age
exsilium	-i	n	exile
tribunus	-i	m	tribune
forum	-i	n	market-place?forum
praeceptum	-i	n	command
negotium	-i	n	business
argentum	-i	n	silver
gladius	-i	m	sword
cibus	-i	m	food
initium	-i	n	beginning
aevum	-i	n	eternity
reus	-i	m	defendant
liber	libri	m	book
nuntius	-i	m	messenger
convivium	-i	n	feast
latrocinium	-i	n	robbery
damnum	-i	n	damage
magister	magistri	m	master
frumentum	-i	n	grain
principium	-i	n	beginning
sepulcrum	-i	n	tomb?grave
rex	regis	m	king
pars	partis	f	part
pater	patris	m	father
corpus	corporis	n	body
urbs	urbis	f	city
homo	hominis	m	human
tempus	-oris	n	time
hostis	-is	c	enemy
mors	mortis	f	death
virtus	-utis	f	virtue
vis	vis	f	force (pl)strength
amor	-oris	m	love
nox	noctis	f	night
caput	capitis	n	head
mare	-is	n	sea
mater	matris	f	mother
nomen	-inis	n	name
os	oris	n	mouth
ignis	-is	m	fire
scelus	-eris	n	crime
miles	-itis	m	soldier
vox	vocis	f	voice
genus	generis	n	origin
mens	mentis	f	mind
mos	moris	m	custom
pectus	-oris	n	chest
parens	-ntis	c	parent
dolor	-oris	m	pain
gens	gentis	f	clan
pes	pedis	m	foot
labor	-oris	m	toil
sanguis	-inis	m	blood
coniunx	coniugis	c	spouse
frater	fratris	m	brother
iter	itineris	n	journey
finis	-is	m	boundary
dux	ducis	c	leader
mons	montis	m	mountain
litus	-oris	n	shore
carmen	-inis	n	song
ratio	-onis	f	reason
ars	artis	f	skill
lex	legis	f	law
munus	muneris	n	offering
iuvenis	-is	m	youth
flumen	-inis	n	river
honor	-oris	m	honor
eques	equitis	m	horseman
lux	lucis	f	light
aetas	-tatis	f	age
ius	iuris	n	right
ops	opis	f	resources
sol	solis	m	sun
consul	-ulis	m	consul
orbis	-is	m	circle
vulnus	-eris	n	wound
opus	operis	n	work
tellus	telluris	f	earth
victor	-oris	m	conqueror
civitas	-atis	f	state
navis	-is	f	ship
agmen	-minis	n	line of march
sidus	-eris	n	star
auris	-is	f	ear
legio	-onis	f	legion
lumen	luminis	n	light
voluptas	-atis	f	pleasure
latus	-eris	n	side?flank
pax	pacis	f	peace
sedes	-is	f	seat
vestis	-is	f	garment
caedes	-is	f	slaughter
ordo	-inis	m	rank
virgo	-inis	f	maiden
aequor	aequoris	n	level surface
laus	laudis	f	praise
comes	comitis	c	comrade
numen	-inis	n	divine will
nemus	nemoris	n	grove
furor	-oris	m	fury
amnis	-is	m	torrent
arbor	arboris	f	tree
civis	-is	c	citizen
crimen	-inis	n	verdict?accusation
libertas	-atis	f	freedom
soror	-oris	f	sister
classis	-is	f	class
fax	facis	f	torch
limen	liminis	n	threshold
prex	precis	f	prayers
funus	funeris	n	funeral?corpse
timor	-oris	m	fear
auctor	-oris	m	founder
animal	-alis	n	soul
decus	decoris	n	grace
salus	-utis	f	health
uxor	uxoris	f	wife
senex	-is	m	elder
frons	frontis	f	forehead
pecus	-oris	n	cattle
sermo	-onis	m	conversation
regio	-onis	f	region
moenia	-ium	n	city walls
clamor	-oris	m	outcry
pudor	pudoris	m	modesty
custos	custodis	m	guardian
pondus	ponderis	n	weight
arx	arcis	f	summit
sors	sortis	f	destiny
facinus	facinoris	n	passionate act?
plebs	plebis	f	commoner
cohors	cohortis	f	cohort
magnitudo	-inis	f	magnitude
vates	-is	m	poet
canis	-is	c	dog
os	ossis	n	bone
fons	fontis	m	fountain
imperator	-oris	m	commander
color	-oris	m	color
multitudo	-inis	f	multitude
oratio	-onis	f	speech
potestas	-atis	f	power
testis	-is	m	witness
aes	aeris	n	copper?bronze
tempestas	-tatis	f	storm
imago	-inis	f	image
libido	-inis	f	lust
maiores	maiorum	m	ancestors
pietas	-tatis	f	devotion
cinis	cineris	c	ashes
cor	cordis	n	heart
hiems	hiemis	f	winter
bos	bovis	m	ox
flos	floris	m	flower
fames	-is	f	famine
error	-oris	m	error
iudex	iudicis	m	judge
lapis	lapidis	m	stone
onus	oneris	n	burden
aer	aeris	m	air
aether	aetheris	n	sky
avis	-is	f	bird
voluntas	-atis	f	desire
hospes	hospitis	m	guest?host
praetor	-oris	m	praetor
rus	ruris	n	country
auctoritas	-atis	f	authority
cupido	-inis	f	desire
necessitas	-tatis	f	necessity
condicio	-onis	f	condition
sacerdos	-dotis	c	priest
consuetudo	-inis	f	custom
dignitas	-atis	f	reputation
mulier	-eris	f	woman
aedes	-is	f	building
volucris	-is	c	bird
fors	fortis	f	chance
manus	-us	f	hand, band
domus	-us	f	home
vultus	-us	m	expression
metus	-us	m	fear
exercitus	-us	m	army
senatus	-us	m	senate
casus	-us	m	chance
cursus	-us	m	course
impetus	-us	m	attack
usus	-us	m	use
sinus	-us	m	crease, bay
currus	-us	m	chariot
fluctus	-us	m	flood
gradus	-us	m	step?rank
cornu	-us	n	horn
spiritus	-us	m	spirit
sensus	-us	m	sense
ictus	-us	m	stroke
fructus	-us	m	fruit
res	rei	f	thing
dies	diei	c	day
fides	-ei	f	trust?faith
spes	spei	f	hope
acies	-ei	f	line
facies	-ei	f	form
species	-ei	f	aspect